0,1,2,3,4,0,1,2,3,4
1,2,3,4,0,1,2,3,4,0
2,3,4,0,1,2,3,4,0,1
3,4,0,1,2,3,4,0,1,2
4,0,1,2,3,4,0,1,2,3
0,1,2,3,4,0,1,2,3,4
1,2,3,4,0,1,0,0,0,0
2,3,4,0,1,2,0,0,0,0
3,4,0,1,2,3,0,0,0,0
4,0,1,2,3,4,0,0,0,0