0,0,0,0,0,4,3,2,1,0
0,1,2,3,4,3,2,1,0,4
0,2,4,1,3,2,1,0,4,3
0,3,1,4,2,1,0,4,3,2
0,4,3,2,1,0,4,3,2,1
4,3,2,1,0,0,0,0,0,0
3,2,1,0,4,0,1,2,3,4
2,1,0,4,3,0,2,4,1,3
1,0,4,3,2,0,3,1,4,2
0,4,3,2,1,0,4,3,2,1